lvl1
WWWWW
WPBGW
WWWWW
lvl2
WWWW000
W00WWW0
W0000W0
W0B00W0
WWW0WWW
W0B0B0W
WGGPGGW
W00B00W
WWW00WW
00WWWW0